----------
----------
----------
----------
----------
----------
----------
====x=====
==========
==========
